3 3
1 1 1 1 1 1 1
1 3 2 0 2 3 1
1 0 0 0 0 0 1
1 0 0 0 0 0 1
1 0 0 0 0 0 1
1 0 0 0 0 0 1
1 3 2 0 2 3 1
1 1 1 1 1 1 1
