4 4 4 4 4 4 4 4 4 4
4 4 4 4 4 4 4 4 4 4
4 4 4 4 4 4 4 4 4 4 
4 1 1 1 1 1 1 1 1 4
4 1 0 0 0 0 0 0 1 4
4 1 0 3 0 2 0 0 1 4
4 1 0 0 0 0 0 0 1 4
4 1 1 1 1 1 0 0 1 4
4 4 4 4 4 1 1 1 1 4
4 4 4 4 4 4 4 4 4 4
1 7 10