4 4 4 4 4 4 4 4 4 4
4 1 1 1 1 1 1 1 4 4
4 1 3 1 3 1 3 1 4 4
4 1 2 1 2 1 2 1 4 4
4 1 0 0 0 0 0 1 4 4
4 1 0 1 0 1 0 1 4 4
4 1 2 1 2 1 2 1 4 4
4 1 3 1 3 1 3 1 4 4
4 1 1 1 1 1 1 1 4 4
4 4 4 4 4 4 4 4 4 4
6 6 7
