4 4 4 4 4 4 4 4 4 4
4 1 1 1 1 1 1 1 4 4
4 1 0 0 0 0 0 1 1 4
4 1 0 2 0 0 0 0 1 4
4 1 2 2 1 1 2 0 1 4
4 1 0 2 3 1 0 0 1 4
4 1 3 3 3 0 3 1 1 4
4 1 1 1 1 1 1 1 4 4
4 4 4 4 4 4 4 4 4 4
4 4 4 4 4 4 4 4 4 4
5 4 8