4 4 4 4 4 4 4 4 4 4
4 1 1 1 1 1 1 1 4 4
4 1 0 1 0 2 3 1 4 4
4 1 3 2 0 0 1 1 4 4
4 1 1 1 0 1 0 1 4 4
4 1 0 0 0 0 0 1 4 4
4 1 0 1 0 1 1 1 4 4
4 1 3 2 0 0 0 1 4 4
4 1 1 1 1 1 1 1 4 4
4 4 4 4 4 4 4 4 4 4
3 8 9
